{

    "tilemap": [
        ["#","#","#","#","#","#","#","#","#","#","#","#", "#","#","#","#","#","#","#","#","#","#","#","#", "#","#","#","#","#","#","#","#","#","#","#","#", "#","#","#","#","#","#","#","#","#","#","#","#"],
        ["#","G","G","G","G","G","G","G","G","G","G","G", "G","G","G","G","G","G","G","G","G","G","G","G", "G","G","G","G","G","G","G","G","G","G","G","G", "G","G","G","G","G","G","G","G","G","G","G","#"],
        ["#","G","G","G","G","G","G","G","G","G","G","G", "G","G","G","G","G","G","G","G","G","G","G","G", "G","G","G","G","G","G","G","G","G","G","G","G", "G","G","G","G","G","G","G","G","G","G","G","#"],
        ["#","G","G","G","G","G","G","G","G","G","G","G", "G","G","G","G","G","G","G","G","G","G","G","G", "G","G","G","G","G","G","G","G","G","G","G","G", "G","G","G","G","G","G","G","G","G","G","G","#"],
        ["#","G","G","G","G","G","G","G","G","G","G","G", "G","G","G","G","G","G","G","G","G","G","G","G", "G","G","G","G","G","G","G","G","G","G","G","G", "G","G","G","G","G","G","G","G","G","G","G","#"],
        ["#","G","G","G","G","G","G","G","G","G","G","G", "G","G","G","G","G","G","G","G","G","G","G","G", "G","G","G","G","G","G","G","G","G","G","G","G", "G","G","G","G","G","G","G","G","G","G","G","#"],
        ["#","G","G","G","G","G","G","G","G","G","G","G", "G","G","G","G","G","G","G","G","G","G","G","G", "G","G","G","G","G","G","G","G","G","G","G","G", "G","G","G","G","G","G","G","G","G","G","G","#"],
        ["#","G","G","G","G","G","G","G","G","G","G","G", "G","G","G","G","G","G","G","G","G","G","G","G", "G","G","G","G","G","G","G","G","G","G","G","G", "G","G","G","G","G","G","G","G","G","G","G","#"],
        ["#","G","G","G","G","G","G","G","G","G","G","G", "G","G","G","G","G","G","G","G","G","G","G","G", "G","G","G","G","G","G","G","G","G","G","G","G", "G","G","G","G","G","G","G","G","G","G","G","#"],
        ["#","G","G","G","G","G","G","G","G","G","G","G", "G","G","G","G","G","G","G","G","G","G","G","G", "G","G","G","G","G","G","G","G","G","G","G","G", "G","G","G","G","G","G","G","G","G","G","G","#"],
        ["#","G","G","G","G","G","G","G","G","G","G","G", "G","G","G","G","G","G","G","G","G","G","G","G", "G","G","G","G","G","G","G","G","G","G","G","G", "G","G","G","G","G","G","G","G","G","G","G","#"],
        ["#","G","G","G","G","G","G","G","G","G","G","G", "G","G","G","G","G","G","G","G","G","G","G","G", "G","G","G","G","G","G","G","G","G","G","G","G", "G","G","G","G","G","G","G","G","G","G","G","#"],
        ["#","G","G","G","G","G","G","G","G","G","G","G", "G","G","G","G","G","G","G","G","G","G","G","G", "G","G","G","G","G","G","G","G","G","G","G","G", "G","G","G","G","G","G","G","G","G","G","G","#"],
        ["#","G","G","G","G","G","G","G","G","G","G","G", "G","G","G","G","G","G","G","G","G","G","G","G", "G","G","G","G","G","G","G","G","G","G","G","G", "G","G","G","G","G","G","G","G","G","G","G","#"],
        ["#","G","G","G","G","G","G","G","G","G","G","G", "G","G","G","G","G","G","G","G","G","G","G","G", "G","G","G","G","G","G","G","G","G","G","G","G", "G","G","G","G","G","G","G","G","G","G","G","#"],
        ["#","G","G","G","G","G","G","G","G","G","G","G", "G","G","G","G","G","G","G","G","G","G","G","G", "G","G","G","G","G","G","G","G","G","G","G","G", "G","G","G","G","G","G","G","G","G","G","G","#"],
        ["#","G","G","G","G","G","G","G","G","G","G","G", "G","G","G","G","G","G","G","G","G","G","G","G", "G","G","G","G","G","G","G","G","G","G","G","G", "G","G","G","G","G","G","G","G","G","G","G","#"],
        ["#","G","G","G","G","G","G","G","G","G","G","G", "G","G","G","G","G","G","G","G","G","G","G","G", "G","G","G","G","G","G","G","G","G","G","G","G", "G","G","G","G","G","G","G","G","G","G","G","#"],
        ["#","G","G","G","G","G","G","G","G","G","G","G", "G","G","G","G","G","G","G","G","G","G","G","G", "G","G","G","G","G","G","G","G","G","G","G","G", "G","G","G","G","G","G","G","G","G","G","G","#"],
        ["#","G","G","G","G","G","G","G","G","G","G","G", "G","G","G","G","G","G","G","G","G","G","G","G", "G","G","G","G","G","G","G","G","G","G","G","G", "G","G","G","G","G","G","G","G","G","G","G","#"],
        ["#","G","G","G","G","G","G","G","G","G","G","G", "G","G","G","G","G","G","G","G","G","G","G","G", "G","G","G","G","G","G","G","G","G","G","G","G", "G","G","G","G","G","G","G","G","G","G","G","#"],
        ["#","G","G","G","G","G","G","G","G","G","G","G", "G","G","G","G","G","G","G","G","G","G","G","G", "G","G","G","G","G","G","G","G","G","G","G","G", "G","G","G","G","G","G","G","G","G","G","G","#"],
        ["#","G","G","G","G","G","G","G","G","G","G","G", "G","G","G","G","G","G","G","G","G","G","G","G", "G","G","G","G","G","G","G","G","G","G","G","G", "G","G","G","G","G","G","G","G","G","G","G","#"],
        ["#","G","G","G","G","G","G","G","G","G","G","G", "G","G","G","G","G","G","G","G","G","G","G","G", "G","G","G","G","G","G","G","G","G","G","G","G", "G","G","G","G","G","G","G","G","G","G","G","#"],
        ["#","G","G","G","G","G","G","G","G","G","G","G", "G","G","G","G","G","#","#","#","G","G","G","G", "G","G","G","G","G","G","G","G","G","G","G","G", "G","G","G","G","G","G","G","G","G","G","G","#"],
        ["#","G","G","G","G","G","G","G","G","G","G","G", "G","G","G","G","G","#","#","G","G","G","G","G", "G","G","G","G","G","G","G","G","G","G","G","G", "G","G","G","G","G","G","G","G","G","G","G","#"],
        ["#","G","G","G","G","G","G","G","G","G","G","G", "G","G","G","G","G","G","G","G","G","G","G","G", "G","G","G","G","G","G","G","G","G","G","G","G", "G","G","G","G","G","G","G","G","G","G","G","#"],
        ["#","G","G","G","G","G","G","G","G","G","G","G", "G","G","G","G","G","G","G","G","G","G","G","G", "G","G","G","G","G","G","G","G","G","G","G","G", "G","G","G","G","G","G","G","G","G","G","G","#"],
        ["#","G","G","G","G","G","G","G","G","G","G","G", "G","G","G","G","G","G","G","G","G","G","G","G", "G","G","G","G","G","G","G","G","G","G","G","G", "G","G","G","G","G","G","G","G","G","G","G","#"],
        ["#","G","G","G","G","G","G","G","G","G","G","G", "G","G","G","G","G","G","G","G","G","G","G","G", "G","G","G","G","G","G","G","G","G","G","G","G", "G","G","G","G","G","G","G","G","G","G","G","#"],
        ["#","G","G","G","G","G","G","G","G","G","G","G", "G","G","G","G","G","G","G","G","G","G","G","G", "G","G","G","G","G","G","G","G","G","G","G","G", "G","G","G","G","G","G","G","G","G","G","G","#"],
        ["#","G","G","G","G","G","G","G","G","G","G","G", "G","G","G","G","G","G","G","G","G","G","G","G", "G","G","G","G","G","G","G","G","G","G","G","G", "G","G","G","G","G","G","G","G","G","G","G","#"],
        ["#","G","G","G","G","G","G","G","G","G","G","G", "G","G","G","G","G","G","G","G","G","G","G","G", "G","G","G","G","G","G","G","G","G","G","G","G", "G","G","G","G","G","G","G","G","G","G","G","#"],
        ["#","G","G","G","G","G","G","G","G","G","G","G", "G","G","G","G","G","G","G","G","G","G","G","G", "G","G","G","G","G","G","G","G","G","G","G","G", "G","G","G","G","G","G","G","G","G","G","G","#"],        
        ["#","G","G","G","G","G","G","G","G","G","G","G", "G","G","G","G","G","G","G","G","G","G","G","G", "G","G","G","G","G","G","G","G","G","G","G","G", "G","G","G","G","G","G","G","G","G","G","G","#"],
        ["#","G","G","G","G","G","G","G","G","G","G","G", "G","G","G","G","G","G","G","G","G","G","G","G", "G","G","G","G","G","G","G","G","G","G","G","G", "G","G","G","G","G","G","G","G","G","G","G","#"],
        ["#","G","G","G","G","G","G","G","G","G","G","G", "G","G","G","G","G","G","G","G","G","G","G","G", "G","G","G","G","G","G","G","G","G","G","G","G", "G","G","G","G","G","G","G","G","G","G","G","#"],
        ["#","#","#","#","#","#","#","#","#","#","#","#", "#","#","#","#","#","#","#","#","#","#","#","#", "#","#","#","#","#","#","#","#","#","#","#","#", "#","#","#","#","#","#","#","#","#","#","#","#"],
        ["#","#","#","#","#","#","#","#","#","#","#","#", "#","#","#","#","#","#","#","#","#","#","#","#", "#","#","#","#","#","#","#","#","#","#","#","#", "#","#","#","#","#","#","#","#","#","#","#","#"],
        ["#","#","#","#","#","#","#","#","#","#","#","#", "#","#","#","#","#","#","#","#","#","#","#","#", "#","#","#","#","#","#","#","#","#","#","#","#", "#","#","#","#","#","#","#","#","#","#","#","#"]
        

    ],

    "objectmap": [
        ["T","T","T","T","T","T","T","T","T","T","T","T", "T","T","T","T","T","T","T","T","T","T","T","T", "T","T","T","T","T","T","T","T","T","T","T","T", "T","T","T","T","T","T","T","T","T","T","T","T"],
        ["T",".",".",".",".",".",".",".",".",".",".",".", ".",".",".",".",".",".",".",".",".",".",".",".", ".",".",".",".",".",".",".",".",".",".",".",".", ".",".",".",".",".",".",".",".",".",".",".","T"],
        ["T",".",".",".",".",".",".",".",".",".",".",".", ".",".",".",".",".",".",".",".",".",".",".",".", ".",".",".",".",".",".",".",".",".",".",".",".", ".",".",".",".",".",".",".",".",".",".",".","T"],
        ["T",".",".",".",".",".",".",".",".",".",".",".", ".",".",".",".",".",".",".",".",".",".",".",".", ".",".",".",".","S",".",".",".",".",".",".",".", ".",".",".",".",".",".",".",".",".",".",".","T"],
        ["T",".",".",".",".",".",".",".",".",".",".",".", ".",".",".",".",".",".",".",".",".",".",".",".", ".",".",".",".",".",".",".",".",".",".",".",".", ".",".",".",".",".",".",".",".",".",".",".","T"],
        ["T",".",".",".",".",".",".",".",".",".",".",".", ".",".",".",".",".",".",".",".",".",".",".",".", ".",".",".",".",".",".",".",".",".",".",".",".", ".",".",".",".",".",".",".",".",".",".",".","T"],
        ["T",".",".",".",".",".",".",".",".",".",".",".", ".",".",".",".",".",".",".",".",".",".",".",".", ".",".",".",".",".",".",".",".",".",".",".",".", ".",".",".",".",".",".",".",".",".",".",".","T"],
        ["T",".",".",".",".",".",".",".",".",".",".",".", ".",".",".",".",".",".",".",".",".","S",".",".", ".",".",".",".",".",".",".",".",".",".",".",".", ".",".",".",".",".",".",".",".",".",".",".","T"],
        ["T",".",".",".",".",".",".",".",".",".",".",".", ".",".",".",".",".",".",".",".",".",".",".",".", ".",".",".",".",".",".",".",".",".",".",".",".", ".",".",".",".",".",".",".",".",".",".",".","T"],
        ["T",".",".",".",".",".",".",".",".",".",".",".", ".",".",".",".",".",".",".",".",".",".",".",".", ".",".",".",".",".",".",".",".",".",".",".",".", ".",".",".","S",".",".",".",".",".",".",".","T"],
        ["T",".",".",".",".",".",".",".",".",".",".",".", ".",".",".",".",".",".",".",".",".",".",".",".", ".",".",".",".",".",".",".",".",".",".",".",".", ".",".",".",".",".",".",".",".",".",".",".","T"],
        ["T",".",".","T",".",".",".",".",".",".",".",".", ".",".",".",".",".",".",".",".",".","S",".",".", ".",".",".",".",".",".",".",".",".",".",".",".", ".",".",".",".",".",".",".",".",".",".",".","T"],
        ["T",".",".",".",".",".",".",".",".",".",".",".", ".",".",".",".",".",".",".",".",".",".",".",".", ".",".",".",".",".",".",".","S",".",".",".",".", ".",".",".",".",".",".",".",".",".",".",".","T"],
        ["T",".",".",".",".",".",".",".",".",".",".",".", ".",".",".",".",".",".",".",".",".",".",".",".", ".",".",".",".",".",".",".",".",".",".",".",".", ".",".",".",".",".",".","T",".",".",".",".","T"],
        ["T",".","T",".",".",".",".",".",".",".",".",".", ".",".",".",".",".",".","T",".",".",".",".",".", ".",".",".",".",".",".",".",".",".",".",".",".", ".",".",".",".",".",".",".",".",".",".",".","T"],
        ["T",".",".",".",".",".","T",".",".",".",".",".", ".",".",".",".",".",".",".",".","S",".",".",".", ".",".",".",".",".",".",".",".",".",".",".",".", ".",".",".",".",".",".",".",".",".",".",".","T"],
        ["T",".",".",".",".",".",".",".",".",".",".",".", ".",".",".",".",".",".",".",".",".",".",".",".", ".",".",".",".",".",".",".",".",".",".",".",".", ".",".",".",".",".",".",".",".",".",".",".","T"],
        ["T",".",".",".",".",".",".",".",".",".",".",".", ".",".",".",".",".",".",".",".",".",".",".",".", ".",".",".",".",".",".",".",".",".",".",".",".", ".",".",".",".",".",".",".",".",".",".",".","T"],
        ["T",".",".",".",".",".",".",".",".",".",".",".", ".",".",".",".",".",".",".",".",".",".",".",".", ".",".",".",".",".",".",".",".",".",".",".",".", ".",".",".",".",".",".",".",".",".",".",".","T"],
        ["T",".",".",".",".",".",".",".",".",".",".",".", ".",".",".",".",".",".",".",".","S",".",".",".", ".","T",".",".",".",".",".",".",".",".",".",".", ".",".",".",".","S",".",".",".",".",".",".","T"],
        ["T",".",".",".",".",".",".","S",".",".",".",".", ".",".",".",".",".",".",".",".",".",".",".",".", ".",".",".",".",".",".",".",".",".",".",".",".", ".",".",".",".",".",".",".",".",".",".",".","T"],
        ["T",".",".",".",".",".",".",".",".",".",".",".", ".",".",".",".",".",".",".",".",".",".",".",".", ".",".",".",".",".",".",".",".",".",".",".",".", ".",".",".",".",".",".",".",".",".",".",".","T"],
        ["T",".",".",".",".",".",".",".",".",".",".",".", ".",".",".",".",".",".",".","S",".",".",".",".", ".",".",".",".",".",".",".",".",".",".",".",".", ".",".",".",".",".",".",".",".",".",".",".","T"],
        ["T",".",".",".",".",".",".",".",".",".",".",".", ".",".",".",".",".",".",".",".",".",".",".",".", ".",".",".",".",".",".",".",".",".",".",".",".", ".",".",".",".",".",".",".",".",".",".",".","T"],
        ["T",".",".",".",".",".",".",".",".",".",".",".", ".",".",".",".",".",".",".",".",".",".",".",".", ".",".",".",".",".",".","T",".",".",".",".",".", ".",".",".",".",".",".",".",".",".",".",".","T"],
        ["T",".",".",".",".",".",".",".",".",".",".",".", ".",".",".",".",".",".",".",".",".",".",".",".", ".",".",".",".",".",".",".",".",".",".",".",".", ".",".",".",".",".",".",".",".",".",".",".","T"],
        ["T",".",".",".",".",".",".",".",".",".",".",".", ".",".",".",".",".",".",".",".",".",".",".",".", ".",".",".",".",".",".",".",".",".",".",".",".", ".",".",".",".",".",".",".",".",".",".",".","T"],
        ["T",".",".",".",".","S",".",".",".",".",".",".", ".",".",".",".",".",".",".",".",".",".",".",".", ".",".",".",".",".",".",".",".",".",".",".",".", ".",".",".",".",".",".",".",".",".",".",".","T"],
        ["T",".",".",".",".",".",".",".",".",".",".",".", ".",".",".",".",".",".",".",".",".",".",".",".", ".",".",".",".",".",".",".",".",".",".",".",".", ".",".",".",".",".",".",".",".",".",".",".","T"],
        ["T",".",".",".",".",".",".",".",".",".",".",".", ".",".",".",".",".",".",".",".",".",".",".",".", ".",".",".",".",".",".",".",".",".",".",".",".", ".",".",".",".",".",".",".",".",".",".",".","T"],
        ["T",".",".",".",".",".",".",".",".",".",".",".", ".",".",".",".",".",".",".",".",".",".",".",".", ".",".",".",".",".",".",".",".",".",".",".",".", ".",".",".",".",".",".",".",".",".",".",".","T"],
        ["T",".",".",".",".",".",".",".",".",".",".",".", ".","P",".",".",".",".",".",".",".",".",".",".", ".",".",".",".",".",".",".",".",".",".",".",".", ".",".",".",".",".",".",".",".",".",".",".","T"],
        ["T",".","T",".",".",".",".",".",".",".",".",".", ".",".","W_Tokarev",".",".",".",".",".",".",".",".",".", ".",".",".",".",".",".",".","T",".",".",".",".", ".",".",".",".",".",".","T",".",".",".",".","T"],
        ["T",".",".",".",".",".",".",".",".",".",".",".", ".",".",".",".",".",".",".",".","T",".",".",".", ".",".",".",".",".",".",".",".",".",".",".",".", ".",".",".",".",".",".",".",".",".",".",".","T"],
        ["T",".",".",".",".",".",".",".",".",".",".",".", ".",".",".",".",".",".",".",".",".",".",".",".", ".",".",".",".",".",".",".",".",".",".",".",".", ".",".",".",".",".",".",".",".",".",".",".","T"],
        ["T",".",".",".",".",".",".",".",".",".",".",".", ".",".",".",".",".",".",".",".",".",".",".",".", ".",".",".",".",".",".",".",".",".",".",".",".", ".",".",".",".",".",".",".",".",".",".",".","T"],
        ["T",".",".",".",".",".",".",".",".",".",".",".", ".",".",".",".",".",".",".",".",".",".",".",".", ".",".",".",".",".",".",".",".",".",".",".",".", ".",".",".",".",".",".",".",".",".",".",".","T"],
        ["T",".",".",".",".",".",".",".",".",".",".",".", ".",".",".",".",".",".",".",".",".",".",".",".", ".",".",".",".",".",".",".",".",".",".",".",".", ".",".",".",".",".",".",".",".",".",".",".","T"],
        ["T",".",".",".",".",".",".",".",".",".",".",".", ".",".",".",".",".",".",".",".",".",".",".",".", ".",".",".",".",".",".",".",".",".",".",".",".", ".",".",".",".",".",".",".",".",".",".",".","T"],
        ["T","T","T","T","T","T","T","T","T","T","T","T", "T","T","T","T","T","T","T","T","T","T","T","T", "T","T","T","T","T","T","T","T","T","T","T","T", "T","T","T","T","T","T","T","T","T","T","T","T"]
    ]


}