{

    "tilemap": [
        ["#","#","#","#","#","#","#","#","#","#","#","#", "#","#","#","#","#","#","#","#","#","#","#","#", "#","#","#","#","#","#","#","#","#","#","#","#", "#","#","#","#","#","#","#","#","#","#","#","#"],
        ["#","G","G","G","G","G","G","G","G","G","G","G", "G","G","G","G","G","G","G","G","G","G","G","G", "G","G","G","G","G","G","G","G","G","G","G","G", "G","G","G","G","G","G","G","G","G","G","G","#"],
        ["#","G","G","G","G","G","G","G","G","G","G","G", "G","G","G","G","G","G","G","G","G","G","G","G", "G","G","G","G","G","G","G","G","G","G","G","G", "G","G","G","G","G","G","G","G","G","G","G","#"],
        ["#","G","G","G","G","G","G","G","G","G","G","G", "G","G","G","G","G","G","G","G","G","G","G","G", "G","G","G","G","G","G","G","G","G","G","G","G", "G","G","G","G","G","G","G","G","G","G","G","#"],
        ["#","G","G","G","G","G","G","G","G","G","G","G", "G","G","G","G","G","G","G","G","G","G","G","G", "G","G","G","G","G","G","G","G","G","G","G","G", "G","G","G","G","G","G","G","G","G","G","G","#"],
        ["#","G","G","G","G","G","G","G","G","G","G","G", "G","G","G","G","G","G","G","G","G","G","G","G", "G","G","G","G","G","G","G","G","G","G","G","G", "G","G","G","G","G","G","G","G","G","G","G","#"],
        ["#","G","G","G","G","G","G","G","G","G","G","G", "G","G","G","G","G","G","G","G","G","G","G","G", "G","G","G","G","G","G","G","G","G","G","G","G", "G","G","G","G","G","G","G","G","G","G","G","#"],
        ["#","G","G","G","G","G","G","#","G","G","G","G", "#","#","#","#","#","#","#","G","G","G","G","G", "G","G","G","G","G","G","G","G","G","G","G","G", "G","G","G","G","G","G","G","G","G","G","G","#"],
        ["#","G","G","G","G","G","G","#","G","G","G","G", "#","G","G","G","G","G","G","G","G","G","G","G", "G","G","G","G","G","G","G","G","G","G","G","G", "G","G","G","G","G","G","G","G","G","G","G","#"],
        ["#","G","G","G","G","G","G","#","G","G","G","G", "#","G","G","G","G","G","G","G","G","G","G","G", "G","G","G","G","G","G","G","G","G","G","G","G", "G","G","G","G","G","G","G","G","G","G","G","#"],
        ["#","G","G","G","G","G","G","#","G","G","G","G", "#","G","G","G","G","G","G","G","G","G","G","G", "G","G","G","G","G","G","G","G","G","G","G","G", "G","G","G","G","G","G","G","G","G","G","G","#"],
        ["#","G","G","G","G","G","G","#","#","#","#","#", "#","#","#","#","#","#","#","G","G","G","G","G", "G","G","G","G","G","G","G","G","G","G","G","G", "G","G","G","G","G","G","G","G","G","G","G","#"],
        ["#","G","G","G","G","G","G","G","G","G","G","G", "#","G","G","G","G","G","#","G","G","G","G","G", "G","G","G","G","G","G","G","G","G","G","G","G", "G","G","G","G","G","G","G","G","G","G","G","#"],
        ["#","G","G","G","G","G","G","G","G","G","G","G", "#","G","G","G","G","G","#","G","G","G","G","G", "G","G","G","G","G","G","G","G","G","G","G","G", "G","G","G","G","G","G","G","G","G","G","G","#"],
        ["#","G","G","G","G","G","G","G","G","G","G","G", "#","G","G","G","G","G","#","G","G","G","G","G", "G","G","G","G","G","G","G","G","G","G","G","G", "G","G","G","G","G","G","G","G","G","G","G","#"],
        ["#","G","G","G","G","G","G","G","G","G","G","G", "#","G","G","G","G","G","#","G","G","G","G","G", "G","G","G","G","G","G","G","G","G","G","G","G", "G","G","G","G","G","G","G","G","G","G","G","#"],
        ["#","G","G","G","G","G","G","#","#","#","#","#", "#","G","G","G","G","G","#","G","G","G","G","G", "G","G","G","G","G","G","G","G","G","G","G","G", "G","G","G","G","G","G","G","G","G","G","G","#"],
        ["#","G","G","G","G","G","G","G","G","G","G","G", "G","G","G","G","G","G","G","G","G","G","G","G", "G","G","G","G","G","G","G","G","G","G","G","G", "G","G","G","G","G","G","G","G","G","G","G","#"],
        ["#","G","G","G","G","G","G","G","G","G","G","G", "G","G","G","G","G","G","G","G","G","G","G","G", "G","G","G","G","G","G","G","G","G","G","G","G", "G","G","G","G","G","G","G","G","G","G","G","#"],
        ["#","G","G","G","G","G","G","G","G","G","G","G", "G","G","G","G","G","G","G","G","G","G","G","G", "G","G","G","G","G","G","G","G","G","G","G","G", "G","G","G","G","G","G","G","G","G","G","G","#"],
        ["#","#","#","#","#","#","#","#","#","#","#","#", "#","#","#","#","#","#","#","#","#","#","#","#", "#","#","#","#","#","#","#","#","#","#","#","#", "#","#","#","#","#","#","#","#","#","#","#","#"],
        ["#","#","#","#","#","#","#","#","#","#","#","#", "#","#","#","#","#","#","#","#","#","#","#","#", "#","#","#","#","#","#","#","#","#","#","#","#", "#","#","#","#","#","#","#","#","#","#","#","#"],
        ["#","#","#","#","#","#","#","#","#","#","#","#", "#","#","#","#","#","#","#","#","#","#","#","#", "#","#","#","#","#","#","#","#","#","#","#","#", "#","#","#","#","#","#","#","#","#","#","#","#"]
        

    ],

    "objectmap": [
        ["T","T","T","T","T","T","T","T","T","T","T","T", "T","T","T","T","T","T","T","T","T","T","T","T", "T","T","T","T","T","T","T","T","T","T","T","T", "T","T","T","T","T","T","T","T","T","T","T","T"],
        ["T",".",".",".",".",".",".",".",".",".",".",".", ".",".",".",".",".",".",".",".",".",".",".",".", ".",".",".",".",".",".",".",".",".",".",".",".", ".",".",".",".",".",".",".",".",".",".",".","T"],
        ["T",".",".",".",".",".",".",".",".",".",".",".", ".",".",".",".",".",".",".","c",".",".",".",".", ".",".",".",".",".",".",".",".",".",".",".",".", ".",".",".",".",".",".",".",".",".",".",".","T"],
        ["T",".",".",".",".",".",".",".",".",".",".",".", ".",".",".",".",".",".",".",".",".",".",".",".", ".",".",".",".",".",".",".",".",".",".",".",".", ".",".",".",".",".",".",".",".",".",".",".","T"],
        ["T",".",".",".",".",".",".",".",".",".",".",".", ".",".",".","c","c","c","c","c",".","c","c","c", ".",".",".",".",".",".",".",".",".",".",".",".", ".",".",".",".",".",".",".",".",".",".",".","T"],
        ["T",".",".",".","t",".",".","t",".",".",".","t", ".",".",".","c",".",".",".",".",".",".",".","c", ".",".",".",".",".",".",".",".",".",".",".",".", ".",".",".",".",".",".",".",".",".",".",".","T"],
        ["T",".",".",".",".",".",".",".",".",".",".",".", ".",".",".","c",".",".",".",".",".","p",".","c", ".",".",".",".",".",".",".",".",".",".",".",".", ".",".",".",".",".",".",".",".",".",".",".","T"],
        ["T",".",".",".",".",".",".",".",".",".",".",".", ".",".",".","c",".",".",".",".",".",".",".","c", ".",".",".",".",".",".",".",".",".",".",".",".", ".",".",".",".",".",".",".",".",".",".",".","T"],
        ["T",".",".",".",".",".",".",".",".",".",".",".", ".",".",".","c",".",".",".",".",".",".",".","c", ".",".",".","p",".",".",".",".",".",".",".",".", ".",".",".",".",".",".",".",".",".",".",".","T"],
        ["T",".",".",".",".",".",".",".",".",".",".",".", ".",".",".",".",".",".",".",".",".","p",".",".", ".",".",".",".",".",".",".",".",".",".",".",".", ".",".",".",".",".",".",".",".",".",".",".","T"],
        ["T",".",".",".",".",".",".",".",".",".",".",".", ".",".",".",".",".",".",".",".",".",".",".",".", ".",".",".",".",".",".",".",".",".",".",".",".", ".",".",".",".",".",".",".",".",".",".",".","T"],
        ["T",".",".",".","p",".",".",".",".",".",".",".", ".",".",".",".",".",".",".",".",".",".",".",".", ".",".",".",".",".",".",".",".",".",".",".",".", ".",".",".",".",".",".",".",".",".",".",".","T"],
        ["T",".",".",".",".",".",".",".",".",".",".",".", ".",".",".",".","p",".",".",".",".",".",".",".", ".",".",".",".",".",".",".",".",".",".",".",".", ".",".",".",".",".",".",".",".",".",".",".","T"],
        ["T",".",".",".",".",".",".",".",".",".",".",".", ".",".",".",".",".",".",".",".","p",".",".",".", ".",".",".",".",".",".",".",".",".",".",".",".", ".",".",".",".",".",".",".",".",".",".",".","T"],
        ["T",".",".",".",".",".",".",".",".",".",".",".", ".",".",".",".",".",".",".",".",".",".",".",".", ".",".",".",".",".",".",".",".",".",".",".",".", ".",".",".",".",".",".",".",".",".",".",".","T"],
        ["T",".",".",".",".",".",".",".",".",".",".",".", ".",".",".",".",".",".",".",".",".",".",".",".", ".",".",".",".",".",".",".",".",".",".",".",".", ".",".",".",".",".",".",".",".",".",".",".","T"],
        ["T",".",".",".",".",".",".",".",".",".",".",".", ".",".",".","P",".",".",".",".",".",".",".",".", ".",".",".",".",".",".",".",".",".",".",".",".", ".",".",".",".",".",".",".",".",".",".",".","T"],
        ["T",".",".",".",".",".",".",".",".",".",".",".", ".",".",".",".",".","W_Tokarev",".","","W_Bat",".",".",".", ".",".",".",".",".",".",".",".",".",".",".",".", ".",".",".",".",".",".",".",".",".",".",".","T"],
        ["T",".",".",".",".",".",".",".",".",".",".",".", ".",".",".",".",".",".",".",".",".",".",".",".", ".",".",".",".",".",".",".",".",".",".",".",".", ".",".",".",".",".",".",".",".",".",".",".","T"],
        ["T",".",".",".",".",".",".",".",".",".",".",".", ".",".",".",".",".",".",".",".",".",".",".",".", ".",".",".",".",".",".",".",".",".",".",".",".", ".",".",".",".",".",".",".",".",".",".",".","T"],
        ["T",".",".",".",".",".",".",".",".",".",".",".", ".",".",".",".",".",".",".",".",".",".",".",".", ".",".",".",".",".",".",".",".",".",".",".",".", ".",".",".",".",".",".",".",".",".",".",".","T"],
        ["T",".",".",".",".",".",".",".",".",".",".",".", ".",".",".",".",".",".",".",".",".",".",".",".", ".",".",".",".",".",".",".",".",".",".",".",".", ".",".",".",".",".",".",".",".",".",".",".","T"],
        ["T","T","T","T","T","T","T","T","T","T","T","T", "T","T","T","T","T","T","T","T","T","T","T","T", "T","T","T","T","T","T","T","T","T","T","T","T", "T","T","T","T","T","T","T","T","T","T","T","T"]
    ]


}