{

    "tilemap": [
        ["G","G","G","G","G","G","G","G","G","G","G","G", "G","G","G","G","G","G","G","G","G","G","G","G", "G","G","G","G","G","G","G","G","G","G","G","G", "G","G","G","G","G","G","G","G","G","G","G","G"],
        ["G","G","G","G","G","G","G","G","G","G","G","G", "G","G","G","G","G","G","G","G","G","G","G","G", "G","G","G","G","G","G","G","G","G","G","G","G", "G","G","G","G","G","G","G","G","G","G","G","G"],
        ["G","G","G","G","G","G","G","G","G","G","G","G", "G","G","G","G","G","G","G","G","G","G","G","G", "G","G","G","G","G","G","G","G","G","G","G","G", "G","G","G","G","G","G","G","G","G","G","G","G"],
        ["G","G","G","G","G","G","G","G","G","G","G","G", "G","G","G","G","G","G","G","G","G","G","G","G", "G","G","G","G","G","G","G","G","G","G","G","G", "G","G","G","G","G","G","G","G","G","G","G","G"],
        ["G","G","G","G","G","G","G","G","G","G","G","G", "G","G","G","G","G","G","G","G","G","G","G","G", "G","G","G","G","G","G","G","G","G","G","G","G", "G","G","G","G","G","G","G","G","G","G","G","G"],
        ["G","G","G","G","G","G","G","G","G","G","G","G", "G","G","G","G","G","G","G","G","G","G","G","G", "G","G","G","G","G","G","G","G","G","G","G","G", "G","G","G","G","G","G","G","G","G","G","G","G"],
        ["G","G","G","G","G","G","G","G","G","G","G","G", "G","G","G","G","G","G","G","G","G","G","G","G", "G","G","G","G","G","G","G","G","G","G","G","G", "G","G","G","G","G","G","G","G","G","G","G","G"],
        ["G","G","G","G","G","G","G","G","G","G","G","G", "G","G","G","G","G","G","G","G","G","G","G","G", "G","G","G","G","G","G","G","G","G","G","G","G", "G","G","G","G","G","G","G","G","G","G","G","G"],
        ["G","G","G","G","G","G","G","G","G","G","G","G", "G","G","G","G","G","G","G","G","G","G","G","G", "G","G","G","G","G","G","G","G","G","G","G","G", "G","G","G","G","G","G","G","G","G","G","G","G"],
        ["G","G","G","G","G","G","G","G","G","G","G","G", "G","G","G","G","G","G","G","G","G","G","G","G", "G","G","G","G","G","G","G","G","G","G","G","G", "G","G","G","G","G","G","G","G","G","G","G","G"],
        ["G","G","G","G","G","G","G","G","G","G","G","G", "G","G","G","G","G","G","G","G","G","G","G","G", "G","G","G","G","G","G","G","G","G","G","G","G", "G","G","G","G","G","G","G","G","G","G","G","G"],
        ["G","G","G","G","G","G","G","G","G","G","G","G", "G","G","G","G","G","G","G","G","G","G","G","G", "G","G","G","G","G","G","G","G","G","G","G","G", "G","G","G","G","G","G","G","G","G","G","G","G"],
        ["G","G","G","G","G","G","G","G","G","G","G","G", "G","G","G","G","G","G","G","G","G","G","G","G", "G","G","G","G","G","G","G","G","G","G","G","G", "G","G","G","G","G","G","G","G","G","G","G","G"],
        ["G","G","G","G","G","G","G","G","G","G","G","G", "G","G","G","G","G","G","G","G","G","G","G","G", "G","G","G","G","G","G","G","G","G","G","G","G", "G","G","G","G","G","G","G","G","G","G","G","G"],
        ["G","G","G","G","G","G","G","G","G","G","G","G", "G","G","G","G","G","G","G","G","G","G","G","G", "G","G","G","G","G","G","G","G","G","G","G","G", "G","G","G","G","G","G","G","G","G","G","G","G"],
        ["G","G","G","G","G","G","G","G","G","G","G","G", "G","G","G","G","G","G","G","G","G","G","G","G", "G","G","G","G","G","G","G","G","G","G","G","G", "G","G","G","G","G","G","G","G","G","G","G","G"],
        ["G","G","G","G","G","G","G","G","G","G","G","G", "G","G","G","G","G","G","G","G","G","G","G","G", "G","G","G","G","G","G","G","G","G","G","G","G", "G","G","G","G","G","G","G","G","G","G","G","G"],
        ["G","G","G","G","G","G","G","G","G","G","G","G", "G","G","G","G","G","G","G","G","G","G","G","G", "G","G","G","G","G","G","G","G","G","G","G","G", "G","G","G","G","G","G","G","G","G","G","G","G"],
        ["G","G","G","G","G","G","G","G","G","G","G","G", "G","G","G","G","G","G","G","G","G","G","G","G", "G","G","G","G","G","G","G","G","G","G","G","G", "G","G","G","G","G","G","G","G","G","G","G","G"],
        ["G","G","G","G","G","G","G","G","G","G","G","G", "G","G","G","G","G","G","G","G","G","G","G","G", "G","G","G","G","G","G","G","G","G","G","G","G", "G","G","G","G","G","G","G","G","G","G","G","G"],
        ["G","G","G","G","G","G","G","G","G","G","G","G", "G","G","G","G","G","G","G","G","G","G","G","G", "G","G","G","G","G","G","G","G","G","G","G","G", "G","G","G","G","G","G","G","G","G","G","G","G"],
        ["G","G","G","G","G","G","G","G","G","G","G","G", "G","G","G","G","G","G","G","G","G","G","G","G", "G","G","G","G","G","G","G","G","G","G","G","G", "G","G","G","G","G","G","G","G","G","G","G","G"],
        ["G","G","G","G","G","G","G","G","G","G","G","G", "G","G","G","G","G","G","G","G","G","G","G","G", "G","G","G","G","G","G","G","G","G","G","G","G", "G","G","G","G","G","G","G","G","G","G","G","G"],
        ["G","G","G","G","G","G","G","G","G","G","G","G", "G","G","G","G","G","G","G","G","G","G","G","G", "G","G","G","G","G","G","G","G","G","G","G","G", "G","G","G","G","G","G","G","G","G","G","G","G"]
        

    ],

    "objectmap": [
        ["T","T","T","T","T","T","T","T","T","T","T","T", "T","T","T","T","T","T","T","T","T","T","T","T", "T","T","T","T","T","T","T","T","T","T","T","T", "T","T","T","T","T","T","T","T","T","T","T","T"],
        ["T",".",".",".",".",".",".",".",".",".",".",".", ".",".",".",".",".",".",".",".",".",".",".",".", ".",".",".",".",".",".",".",".",".",".",".",".", ".",".",".",".",".",".",".",".",".",".",".","T"],
        ["T",".",".",".",".",".",".",".",".",".",".",".", ".",".",".",".",".",".",".",".",".",".",".",".", ".",".",".",".",".",".",".",".",".",".",".",".", ".",".",".",".",".",".",".",".",".",".",".","T"],
        ["T",".",".",".",".",".",".",".",".",".",".",".", ".",".",".",".",".",".",".",".",".",".",".",".", ".",".",".",".",".",".",".",".",".",".",".",".", ".",".",".",".",".",".",".",".",".",".",".","T"],
        ["T",".",".",".",".",".",".",".",".",".",".",".", ".",".",".",".",".",".",".",".",".",".",".",".", ".",".",".",".",".",".",".",".",".",".",".",".", ".",".",".",".",".",".",".",".",".",".",".","T"],
        ["T",".",".",".",".",".",".",".",".",".",".",".", ".",".",".",".",".",".",".",".",".",".",".",".", ".",".",".",".",".",".",".",".",".",".",".",".", ".",".",".",".",".",".",".",".",".",".",".","T"],
        ["T",".","P",".",".",".",".",".",".",".",".",".", ".",".",".",".",".",".",".",".",".","p",".",".", ".",".",".",".",".",".",".",".",".",".",".",".", ".",".",".",".",".",".",".",".",".",".",".","T"],
        ["T",".",".",".",".",".",".",".",".",".",".",".", ".",".",".",".",".",".",".",".",".",".",".",".", ".",".",".",".",".",".",".",".",".",".",".",".", ".",".",".",".",".",".",".",".",".",".",".","T"],
        ["T",".",".",".",".",".",".",".",".",".",".",".", ".",".",".",".",".",".",".",".",".",".",".",".", ".",".",".","p",".",".",".",".",".",".",".",".", ".",".",".",".",".",".",".",".",".",".",".","T"],
        ["T",".",".",".",".",".",".",".",".",".",".",".", ".",".",".",".",".",".",".",".",".","p",".",".", ".",".",".",".",".",".",".",".",".",".",".",".", ".",".",".",".",".",".",".",".",".",".",".","T"],
        ["T",".",".",".",".",".",".",".",".",".",".",".", ".",".",".",".",".",".",".",".",".",".",".",".", ".",".",".",".",".",".",".",".",".",".",".",".", ".",".",".",".",".",".",".",".",".",".",".","T"],
        ["T",".",".",".","p",".",".",".",".",".",".",".", ".",".",".",".",".",".",".",".",".",".",".",".", ".",".",".",".",".",".",".",".",".",".",".",".", ".",".",".",".",".",".",".",".",".",".",".","T"],
        ["T",".",".",".",".",".",".",".",".",".",".",".", ".",".",".",".","p",".",".",".",".",".",".",".", ".",".",".",".",".",".",".",".",".",".",".",".", ".",".",".",".",".",".",".",".",".",".",".","T"],
        ["T",".",".",".",".",".",".",".",".",".",".",".", ".",".",".",".",".",".",".",".","p",".",".",".", ".",".",".",".",".",".",".",".",".",".",".",".", ".",".",".",".",".",".",".",".",".",".",".","T"],
        ["T",".",".",".",".",".",".",".",".",".",".",".", ".",".",".",".",".",".",".",".",".",".",".",".", ".",".",".",".",".",".",".",".",".",".",".",".", ".",".",".",".",".",".",".",".",".",".",".","T"],
        ["T",".",".",".",".",".",".",".",".",".",".",".", ".",".",".",".",".",".",".",".",".",".",".",".", ".",".",".",".",".",".",".",".",".",".",".",".", ".",".",".",".",".",".",".",".",".",".",".","T"],
        ["T",".",".",".",".",".",".",".",".",".",".",".", ".",".",".",".",".",".",".",".",".",".",".",".", ".",".",".",".",".",".",".",".",".",".",".",".", ".",".",".",".",".",".",".",".",".",".",".","T"],
        ["T",".",".",".",".",".",".",".",".",".",".",".", ".",".",".",".",".","W_Tokarev",".","","W_Bat",".",".",".", ".",".",".",".",".",".",".",".",".",".",".",".", ".",".",".",".",".",".",".",".",".",".",".","T"],
        ["T",".",".",".",".",".",".",".",".",".",".",".", ".",".",".",".",".",".",".",".",".",".",".",".", ".",".",".",".",".",".",".",".",".",".",".",".", ".",".",".",".",".",".",".",".",".",".",".","T"],
        ["T",".",".",".",".",".",".",".",".",".",".",".", ".",".",".",".",".",".",".",".",".",".",".",".", ".",".",".",".",".",".",".",".",".",".",".",".", ".",".",".",".",".",".",".",".",".",".",".","T"],
        ["T",".",".",".",".",".",".",".",".",".",".",".", ".",".",".",".",".",".",".",".",".",".",".",".", ".",".",".",".",".",".",".",".",".",".",".",".", ".",".",".",".",".",".",".",".",".",".",".","T"],
        ["T",".",".",".",".",".",".",".",".",".",".",".", ".",".",".",".",".",".",".",".",".",".",".",".", ".",".",".",".",".",".",".",".",".",".",".",".", ".",".",".",".",".",".",".",".",".",".",".","T"],
        ["T","T","T","T","T","T","T","T","T","T","T","T", "T","T","T","T","T","T","T","T","T","T","T","T", "T","T","T","T","T","T","T","T","T","T","T","T", "T","T","T","T","T","T","T","T","T","T","T","T"]
    ]


}