{

    "tilemap": [
        ["G","G","G","G","G","G","G","G","G","G","G","G"],
        ["G","G","G","G","G","G","G","G","G","G","G","G"],
        ["G","G","G","G","G","G","G","G","G","G","G","G"],
        ["G","G","G","G","G","G","G","G","G","G","G","G"],
        ["G","G","G","G","G","G","G","G","G","G","G","G"],
        ["G","G","G","G","G","G","G","G","G","G","G","G"],
        ["G","G","G","G","G","G","G","G","G","G","G","G"],
        ["G","G","G","G","G","G","G","G","G","G","G","G"],
        ["G","G","G","G","G","G","G","G","G","G","G","G"],
        ["G","G","G","G","G","G","G","G","G","G","G","G"],
        ["G","G","G","G","G","G","G","G","G","G","G","G"],
        ["G","G","G","G","G","G","G","G","G","G","G","G"]
        

    ],

    "objectmap": [
        [".",".",".",".",".",".",".",".",".",".",".","."],
        [".","p",".",".",".","p",".",".",".",".",".","."],
        [".",".",".",".",".",".",".",".",".",".",".","."],
        [".",".",".",".",".",".",".",".",".",".",".","."],
        [".",".",".",".",".",".","p",".",".","p",".","."],
        [".",".",".",".",".",".",".",".",".",".",".","."],
        [".",".",".",".",".",".",".",".",".","T",".","."],
        [".",".",".","T",".",".",".",".",".",".",".","."],
        [".","p",".",".",".","P",".",".","p",".",".","."],
        [".",".",".",".",".",".",".",".",".",".",".","."],
        [".",".",".",".",".",".",".","T",".",".",".","."],
        [".",".",".",".",".",".",".",".",".",".",".","."]
    ]


}