{

    "tilemap": [
        ["#","#","#","#","#","#","#","#","#","#","#","#"],
        ["#","G","G","G","G","G","G","G","G","G","G","#"],
        ["#","G","G","G","G","G","G","G","G","G","G","#"],
        ["#","G","G","G","G","G","G","G","G","G","G","#"],
        ["#","G","G","G","G","G","G","G","G","G","G","#"],
        ["#","G","G","G","G","G","G","G","G","G","G","#"],
        ["#","#","#","#","#","#","#","#","#","#","#","#"]
        

    ],

    "objectmap": [
        [".",".",".",".",".",".",".",".",".",".",".","."],
        [".",".",".",".",".",".",".",".",".","T",".","."],
        [".",".",".","T",".",".",".",".",".",".",".","."],
        [".",".",".",".",".","P",".",".",".",".",".","."],
        [".",".",".",".",".",".",".",".",".",".",".","."],
        [".",".",".",".",".",".",".","T",".",".",".","."],
        [".",".",".",".",".",".",".",".",".",".",".","."]
    ]


}